the shawshank redemptioncarflo26 : Tied for the best movie I have ever seen.

the shawshank redemptionmr.white : Why do I want to write the 234th comment on The Shawshank Redemption? it's perfect. 

the shawshank redemptionscoobyDOO : I am not sure - almost everything that could be possibly said about it has been said.

the godfatherMR_Heraclius23 : The greatest movie of all time!

the godfatherYoFella : One of the best films of all time, an absolute masterpiece.

the dark knightMR_Heraclius12 : Confidently directed, dark, brooding, and packed with impressive action sequences and a complex story!

the dark knightMiss lia : The Dark Knight includes acareer-defining turn from Heath Ledger as well as other Oscar worthy performances.

the godfather part 2Romeo : Best gangster dramas of all time arguably "The Godfather: Part II" is a very suspenseful drama.

12 angry menJuliee : I always thought it would be difficult to get involve in the context, I couldn't be more wrong!

12 angry menVanya : It is a great example of how a simple film can do magic with good actors, an what great actors they are!

the lord of the rings: the return of the kingrambo : A Timeless Classic This movie, and trilogy in general, is a cinematic masterpiece. 

the lord of the rings: the return of the kingAman : I love this movie much it's become a tradition to watch the Lord of the Rings series at least once a year! 

pulp fictionchimbal : Not overrated at all Before I saw this I assumed it was probably overrated. 

pulp fictionPhoebe : I was wrong. It has probably changed the way I will look at movies for the rest of my life.

schindler's listFella_shibby9 : There just isn't anything like this film. 

schindler's listFella : Bring me the heads of Hitler, Himmler, Eichmann n Mengele.Schindler's List is undoubtedly the best Holocaust film ever made.

inceptionsrcooper :  Is it possible the makers understand how incredible this film is? 

inceptionBINOD : BINOD.

inceptionMinal : It is spectacular, and brutal, and enigmatic and disturbing.

inceptionSloni : It is beautiful and absorbing. 

fight clubPluto : A great movie you can watch again and again Because you'll probably be confused the first time around. 

fight clubNina : Beleive me if you want to feel this movie to the core watch it twice. 

the lord of the rings : The Fellowship of the RingCooloy : an absolute masterpiece in cinematic history!

forrest gumpJupiter : Quite possibly the best movie ever made. 

forrest gumpDIYA : It's just as good as Christmas!

the good, the bad and the uglyMan_with_the_hood : the greatest of the great!

drishyam 2nirmalamarwade19 : Outstanding brilliant lajawab No words to explain one day south industry will rule Indian cinema.

the lord of the rings: the two towers power rangerAstha : A True Fantasy Movie.

the matrixYour fella : One of the best action sci fi action movies of all time! 

the matrixMr.white : On another level entirely to any other science fiction film from the last 20 years.

goodfellasHudley : There is no downside here and this movie is embedded as one of the best mafia movies out there,highly recommended.

star wars: episode 5 - the empire strikes backhulk : Best of the best I cannot believe some people out there didn't like this film!

one flew over the cuckoo's nestCuckoo : A masterpiece. 

parasiteAnonymous : A true masterpiece. 

parasiteBINOD : BINOD. 

parasiteAsthahahaha : It will make you belly laugh, it will chill you to the bone, and it will make you shed a tear.

interstellarYashi : I am saying This without any doubt it is THE BEST MOVIE EVER MADE.

interstellarMINI : There is something much more in this movie than meets the eye .. Watch it and find for yourself!

city of godAngel Priya : It was an awesome re-enactment of a true story - powerful, moving, raw, real - and even funny in parts.

city of godNishi : I gave it ten out of ten. Please see it if you can.

spirited awayRoss : Personally, I've never seen anything as original in an animated film as in this deeply mythical fairytale. 

spirited awayYoFella : What a surreal idea for a movie! It's hard to find an adequate description.

saving private ryanBazzi : No one understood what was going on: The terror, the chaos, the maelstrom of bullets, the near-deafening explosionsYou really got a sense of what these guys had to go through.

the green mileJoey Tribbiani : Actually this is not one single story, but several tied together seamlessly.

life is beautifulPluto : "Life is Beautiful" is a film about love, optimism, courage and inner strength. Have a box of tissues handy. Best film ever seen!!!

sevenBinod : This movie is from start to finish a well produced and directed film. The performances in this movie are outstanding.

sevenKhamtrii : Pitt once again, makes his role a stand-out performance by putting his versatile acting skills. 

sevenSalonhehehehe : Morgan Freeman is well-cast. His brooding acting style fits the character very well.

sevenBINOD : BINOD.

sevenMinaaaal : A great movie you can watch again and again.

the silence of the lambsLion : I read the book first, was fascinated by it, and couldn't wait for the film to come out.I was expecting an intense movie and I got it.

star wars: episode 4 - a new hopeDoc Strange : They were instant pop culture icons; you got the sense you'd seen them before somewhere, but were sure this wasn't possible.

harakirilstrawser :Harakiri is an excellent human drama set in feudal Japan that involves a ronin presenting himself to a powerful clan and asking to commit harikiri.

pather panchalippmukherjee : No doubt it ranks in top 100 movie list from Time magazine, not to speak of almost all Indian publications connected with films rate this one as THE MOVIE.

it's a wonderful lifejon-larsen : Everything is so great in this movie. The story is amazing.The whole movie is amazing,touching and encouraging.

whiplashbbickley13-921-58664 : This movie was far better than the trailer made it look. I've been a fan of Miles Teller for a while and this movie just increase my fandom

untouchablejvdesuit1: It's not because I'm French that I appreciated this movie which I've seen twice. A great movie you can watch again and again.

the prestigeJulia-Dempster : This was the best movie I have seen in at least the past two years.this movie was truly a masterpiece and kept me guessing the whole time.

the departedghalibalfalasi : I have yet to watch a good or a very good Martin Scorsese movie. Every movie I watched is a 10.

the pianistQuinoa1984 : The Pianist tells the story of such a man in war time Poland,who from start to finish sees his life literally getting worse and worse and worse.

gladiatormahmus : Gladiator is the best bread and circus. A moving and very entertaining action epic. I absolutely love Joaquin Phoenix in this movie. He's the kind of villain you love to hate.

american historyDanielStephens1988 : The tragedy of evil is that in trying to stop it, you create it. So if you want to stop doing evil actions, you also have to stop seeing evil because to see evil you must project evil... therefore, you create evil.

the usual suspectsdbdumonteil : It's a sensational debut for Bryan Singer which enabled to put him on the map. 

leongenghiskhan-99478 : Beautiful movie with violence and professionalism, action, cool characters and amazing character development.

the lion kingQuinoa1984 : The Lion King is a great film. Along with a great story, terrific animation, and an all star cast of voices, there are the lessons that are learned from this film.

the lion kingNemo : It was part of my childhood and it is a film experience I will never forget. And hopefully, you won't either. A++

the lion kingBINOD : BINOD.

terminator 2: judgment daySmells_Like_Cheese : All the cast members gives a great performance. great entertainment.

cinema paradisoBoyo-2 : This movie is very sentimental, so if you are proud of your cynical side, stay away. For the rest of us, this is a masterpiece! Enjoy the movie and enjoy yourself!

cinema paradisoFIFI : The end is so beautiful that it is almost unbelievable.

grave of the firefliesdee.reid : "Grave of the Fireflies" is one of the most ambitious, depressing, and quite frankly, best films that I've ever seen.

back to the futureAnonymous_Maxine : Back To The Future is such an inventive and exciting piece of filmmaking that it is impossible to forget about it.

once upon a time in the westchuck-hickl : To watch this again after so many years and after so much has changed in movie making, what a joy.

once upon a time in the westchuckiee : If you appreciate excellent camera work, scene making and soundtrack working together,you would not be disappointed.

psychodarkjosh : One of the few memorable cinematic killers that does not adhere to these restraints and cliches is.
